00000000000000000000
00000000000000000000
00000011111111000000
00000010111101000000
00000011111111000000
00000000000000000000
00000000000000000000
00000000000000000000
00000000000000000000
00000000000000000000